NO ./tex/mike.xpm
SO ./tex/saul.xpm
WE ./tex/sad.xpm
EA ./tex/happy.xpm

F 41, 41, 41
C 0, 0, 0

1111111
1001001
1010011
1000N1
111111
