NO ./tex/burningskull.xpm
SO ./tex/indian.xpm
WE ./tex/saul.xpm
EA ./tex/bingus.xpm

F 220,100,0
C 225,30,0



11111111111111111111111111111111111111
10000000000000000000000000000000000001
10000000000000011111111000000000000001
10000000000000011111111000000000000001
10000000000000011111111000000000000001
10000000000000011111111000000000000001
10000000000000011111111000000000000001
10000000000000011111111000000000000001
100000000000000000N0000000000000000001
10000000000000000000000000000000000001
10000000000000011111111000000000000001
1000000000000001      1000000000000001
1000000000000001      1000000000000001
1000000000000001      1000000000000001
1111111111111111      1111111111111111